#################~~~~~~~~~~
#################    =~   #
~~  S~~~~    ==   =~==~   #
 ~~~~~ ~~~  ====  ==~=~~  #
 ~   ===~~   #==   =~=~~  #
~~   ===~~  ###    =~     #
~~~  ===~~  ##   ###~     #
~=~    ~~        ## ~   ###
 =~   ~  ##  == =~ =~   ###
~~    ==###  == =~      ###
##########   ==        ~###
~~~~~~~~         ~~~~##~   
 ### # # ### ### ====##=   
 # # # # #   # #   ==~~~=  
 ### # # #   ###   =~~~==  
 #   # # #   #     =##~E   
 #   ### ### #     =##     
~~~~~~~~~~~~~~~~~~~~~~~~~~~